#################################....###
#......................................#
#......................................#
........................................
........................................
........................................
#......................................#
#......................................#
#......................................#
#......................................#
#......................................#
#......................................#
........................................
........................................
........................................
........................................
.......................................#
.......................................#
#################################....###
